###########
# *   * * #
# * * *   #
# * * * * #
    *   *. 
###########
