# ##################
                    
## #################
                    
######### ##########
                    
################## #
 .                  
# ##################
