###########
# *   * * #
# * * *   #
# * * * * #
#   *   *.#
###########
