####################
# *       ......   #
#                 *#
#    .             #
#              .   #
#                  #
#    ......        #
#                  #
# *              * #
####################
