####################
  *       ......   #
#                 *#
#    .             #
#              .                    
#                  #
#    ......        #
#                  #
# *              * #
############# ######

