####################
#                  #
## #################
#                  #
######### ##########
#                  #
################## #
#.                 #
####################
