####################
# *       ......   #
#                 *#
#    .             #
#              .                    
#                  #
#    ......        #
#                  #
# *              * #
############# ######

